{
  "title": "Tutorial 1",
  "width": 10,
  "height": 8,
  "tiles": [
     8,  5,  5,  5,  5,  5,  5,  5, 13,  9,
     6, -1, -1, -1, -1, -1, -1, -1,  7, 14,
     6, -1,  2,  5, 13,  5,  4, -1, -1,  6,
     6, -1, -1, -1,  6, -1, -1, -1, -1,  6,
     6, -1,  3, -1,  6, -1,  8,  9, -1,  6,
     6, -1,  6, -1,  1, -1,  7, 10, -1,  6,
     6, -1,  6, -1, -1, -1, -1, -1, -1,  6,
     7,  5, 11,  5,  5,  5,  5,  5,  5, 10
  ],
  "entities": {
    "PacPac": {
      "x": 3,
      "y": 5
    },
    "Slimes": [
      {
        "x": 6,
        "y": 1
      }
    ]
  }
}